#domain
hospital
#levelname
SAsoko1_48
#colors
blue: 0, A
#initial
++++++++++++++++++++++++++++++++++++++++++++++++
+0A                                            +
++++++++++++++++++++++++++++++++++++++++++++++++
#goal
++++++++++++++++++++++++++++++++++++++++++++++++
+                                             A+
++++++++++++++++++++++++++++++++++++++++++++++++
#end
