#domain
hospital
#levelname
MAMASAI
#colors
red: 0, A
green: 1, B
blue: 2, C
#initial
+++++++++
++++0++++
++++ ++++
++++ ++++
+1 C2C B+
++++ ++++
++++ ++++
++++A++++
+++++++++
#goal
+++++++++
++++1++++
++++ ++++
++++ ++++
+0     A+
++++ ++++
++++ ++++
++++B++++
+++++++++
#end