#domain
hospital
#levelname
MAMKM
#colors
red: 0, A
blue: 1
#initial
+++++++++++++++++
+ A    1       0+
++++++++++++++ ++
+++++++++++++++++
#goal
+++++++++++++++++
+A              +
++++++++++++++ ++
+++++++++++++++++
#end
