#domain
hospital
#levelname
SAsimple1
#colors
blue: 0, A
#initial
+++++++++++++
+   0     A +
+ +++++++++ +
+           +
+++++++++++++
#goal
+++++++++++++
+          A+
+ +++++++++ +
+           +
+++++++++++++
#end
